WWWWWWWWWWWWWWWW
WCCCCCCCCCCCCCCW
WCCCCCCCCCCECCCW
WCCCCCCCCCCCCCCW
WCCCCCCCCCWCCCCW
WCCWWWCCCCWCCCCW
WCCWWWCCCCWCCCCW
WCCCCCCCCCWCCCCW
WCCCCCCCCCCCCCCW
WCCCPCCCCCCCCCCW
WCCCCCCCCCCCCCCW
WWWWWWWWWWWWWWWW